R 1024 768 
NO ./tex/elinia1.xpm
SO ./tex/elinia.xpm
WE ./tex/elinia2.xpm
EA ./tex/elinia3.xpm

S ./tex/slime.xpm
F ./tex/elinia_floor.xpm
C ./tex/elinia_sky1.xpm

        1111111111111111111111111
        1000000002110000000000001
        1011000011110000000000001
        1001000000000000000010001
111111111011000001110000000010201             
100000000011000001110011110011111111111111111111111111111111111
101101111011110111000000010000000000000010000000000000010000001
121101111001110111010100100000000000000002000000000000002000001
110000001101010111000000000000000000000000000000000000000000001
10E000000000000000000000000000000000000000000002000000000200001
100000000000000011010100020000001020000000000010000000000100001
110000011101010111110111100011111111111111111111111111111111111
11102011 1102021 120010200001
11111111 1111111 111111111111


