R 640 480 
NO ./tex/eagle.xpm
SO ./tex/redbrick.xpm
WE ./tex/purplestone.xpm
EA ./tex/greystone.xpm

S ./tex/greenlight.xpm
F ./tex/wood.xpm
C 50,20,50 


        1111111111111111111111111
        1000000000110000000000001
        1011000001110000002000001
        1001000000000000000000001
111111111011000001110000000000001
1000000000110000011100111100111111111111111111111111
1011011110111101110000000100000000000000100000000001
1011011110011101110101001000000000000000100000000001
1100000011010101110000000000222220000000100000100001
1000200000000000000000000000000000000000000000100001
1000000000000000110101000000000001000000000000100001
11000001110101011111011110N0111111111111111111111111
11110111 1110101 101111010001
11111111 1111111 111111111111
