R 640 640
NO ../textures/redbrick.xpm
SO ../textures/eagle.xpm
WE ../textures/greystone.xpm
EA ../textures/mossy.xpm

S ../textures/greenlight.xpm
F ../textures/mossy.xpm
C ../textures/eagle.xpm


111
101
111

        1111111111111111111111111
        1000000000110000000000001
   1    1011000001110000000000001
        1001000000000000000000001
111111111011000001110000000000001
100000000011000001110111111111111
11110111111101011100000010001111111111111111111111111111111111111111111111
11110111111101011101010010000000000000000000000000000000000000000000000011
11N0000000000000000000000000000000000000000000000000000000000000000000001
1000022000000220000000220000111111111111111111111111111111111111111111111
10000000000000001101010010001
110000011101010111110111100111
11110111 1110101 101111010001
11111111 1111111 111111111111
