R 1024 768 
NXT ./jakum.cub

NO ./tex/rudy1.xpm
SO ./tex/rudy2.xpm
WE ./tex/rudy3.xpm
EA ./tex/rudy4.xpm

S ./tex/toy_horse_128.xpm
F ./tex/rudy_bottom.xpm
C ./tex/rudy_sky.xpm

        1111111111111111111111111        11111111111111111111111
        1000000002112001000000001        10000000021002000000001
        1011000011110001000000001        10102010001000000100001
        1000000000000001000010001        10011100000002002120001
111111111000000001110002000010201        1000200011111111111110111
100000000000200001110000000011111111111111111000000002000000000001
100101000011100111000000010000000021000001000000000000010000001101
120001111000200100000000210000000001000000020000000000000020001201
110000001101010111000000010000000001000011000000000010111111101001
10000E0000000000000000000000000010000000110000020000101     101201
1000000000000000110111111001000012000000000000100000101     100001
1100000111010101110000000001111111111111111111111111101     101111
11102001 1120021 120010200001                       101  111101
1111100111111111 111111110001            11111111111101  100001
     1021               10001     11111  10002000000001  102001
     1001               10001     100011110000001111111  100001
     1001           111110001111111000000000111011       101111
     10011111111111110200000000002000000000000001        101
     12000000000000000000000000000000000200000001        101
     11111111111111111111111111111111111100000001        101
                                        10202020111111111101
                                        10000000000000000001
                                        11111111111111111111
