R 640 480
NO ../textures/redbrick.xpm
SO ../textures/eagle.xpm
WE ../textures/greystone.xpm
EA ../textures/mossy.xpm

S ../textures/greenlight.xpm
F 123,23,23
C ../textures/eagle.xpm


111
101
111

        1111111111111111111111111
        1222222222112222222222221
   1    1211222221112222222222221
        1221222222222222222222221
111111111211222221112222222222221
122222222211222221112111111111111
11112111111121211122222212221
11112111111121211121212212221
11222222112121211122222222221
12222222222222222222222222221
1222222222222222112121N212221
112222211121212111112111122111
11112111 1112121 121111212221
11111111 1111111 111111111111
