R 640 480 
NO ./tex/eagle.xpm
SO ./tex/redbrick.xpm
WE ./tex/purplestone.xpm
EA ./tex/greystone.xpm

S ./tex/orange_mush.xpm
F 48,1,123
C 23,23,24
        1111111111111111111111111
        1000000002110000000000001
        1011000011110000000000001
        1001000000000000000010001
111111111011000001110000000010201             
1000000000110000011100111100111111111111111111111111
1011011110111101110000000100000000000000100000000001
1211011110011101110101001000000000000000102000000001
1100000011010101110000000000000000000000100000100001
1000000000000000000000000000000000000000000000102001
1000000000000000110101000000000010200000000000100001
1100000111010101111101111000111111111111111111111111
11102011 1102021 120010200W01
11111111 1111111 111111111111


