R 1024 1024 
NXT ./elinia.cub

NO ./tex/jakum1.xpm
SO ./tex/jakum2.xpm
WE ./tex/jakum3.xpm
EA ./tex/jakum4.xpm

S ./tex/jakum(1).xpm
F ./tex/jakum_b.xpm
C ./tex/jakum_c.xpm


1111111111111111111111111
1000000000000000000000001
1100000000111000000000011
1000000000000000000000001
1000E00000000000000020001
1000000000000000000000001
1100011100000111000000011
1000000000000000000000111
1111111111111111111111111
