R 1024 1024
NXT ./ex2.cub

NO ../textures/moonn.xpm
SO ../textures/moons.xpm
WE ../textures/moonw.xpm
EA ../textures/moone.xpm

S ../textures/zil.xpm ../textures/medic.xpm ../textures/c14rifle256.xpm ../textures/scouge3.xpm
F ../textures/moon.xpm
C ../textures/space.xpm

11111111111111111111111111111111111111111111111111111111111111111111111111
10000000000000000000000000000000000000000000000000000000000000000000000001
10111111111111111111111111111111111111111111111111111111111111111111111111
10000001
1000001
1000001 1111111111111111111111111
1011111 1000000000110000000000001
1011    1011000001110000000000001
101     1001000000000000000000001
101111111011000001110000000000001
100000000011000001110111111111111
1111011111110101110000001000111111111111111111111111111111111111111111111
1111011111110101110101001000000000000000000000000000000000000000000000001
1100000000000000000000000000000000000000000000000000000000000000000000001
1000000000000000000000000000000000000000000000000000000000000000000000001
100E000000000000000000000000000000000000000000000000000000000000000000001
1000000000000000000000000000000000000000000000000000000000000000000000001
1000000000000000000000000000000000000000000000000000000000000000000000001
1000000111111110000000000000000000000000000000000000000000000000000000001
10000001      10000000000000000000000000000000000000000000000000000000001
1000000111111110000000000000000000000000000000000000000000000000000000001
1000000000004000000000000000000000000000000000000000000000000000000000001
1000000030000000005005000000000000000000000000000000000000000000000000001
1000022000000220000000220000111111111111111111111111111111111111111111111
10000000000000001101010010001
110000011101010111110111100111
11110111 1110101 101111010001
11111111 1111111 111111111111
