R 1024 1024
NXT ./ex.cub
NO ../textures/redbrick.xpm
SO ../textures/eagle.xpm
WE ../textures/greystone.xpm
EA ../textures/mossy.xpm

S ../textures/zil.xpm
F ../textures/purplestone.xpm
C ../textures/space.xpm

11111111111
10000000001
10020000001
10002000001
1N000000001
10000000001
11111111111

