R 1024 1024 
NXT ./rudy.cub

NO ./tex/elinia1.xpm
SO ./tex/elinia.xpm
WE ./tex/elinia2.xpm
EA ./tex/elinia3.xpm

S ./tex/pairy.xpm ./tex/tree_st.xpm ./tex/orange_potion.xpm ./tex/mana.xpm ./tex/potal_elinia.xpm
F ./tex/elinia_floor.xpm
C ./tex/elinia_sky1.xpm

        1111111111111111111111111
        1000000002112000000000001
        1011000011110000000000001
        1001000000000000000010001
111111111011000001110002000010201             
100000000011200001110011110011111111111111111111111111111111111
101101111011110111000000010000000021000001000000000000210020001
161101111001210111010100100000000001000000200000000000010400S01
110000001101010111000000000000000001000000000000000010000000001
100003000000000000000000000000000000000000000002000010000103501
100000000000400011010100020000001200000000000010000010000100001
110000011101010111110111100011111111111111111111111111111111111
11102011 1120021 120010200001
11111111 1111111 111111111111


