R 3000 3300
NO ./tex/eagle.xpm
SO ./tex/redbrick.xpm
WE ./tex/purplestone.xpm
EA ./tex/greystone.xpm

S ./tex/greenlight.xpm
F ./tex/wood.xpm
C ./tex/greenlight.xpm


        1111111111111111111111111
        1000000000110000000000001
        1011000001110000002000001
        1001000000000000000000001
111111111011000001110000000000001
100000000011000001110011111111111
11110111111111011100000010001
11110111111111011101010010001
11000000110101011100000000001
10002000000000000000000000001
10000000000000001101010000001
11000001110101011111011110N0111
11110111 1110101 101111010001
11111111 1111111 111111111111
