R 640 640
NO ../textures/redbrick.xpm
SO ../textures/eagle.xpm
WE ../textures/greystone.xpm
EA ../textures/mossy.xpm

S ../textures/zil.xpm
F ../textures/purplestone.xpm
C ../textures/space.xpm


1111111
1000001
1002001
1N00201
1111111

